{
  "name": "classic_arena",
  "rows": 18,
  "cols": 28,
  "grid": [
    [2,2,2,2,2,2,2,2,2,2,2,2,2,2,2,2,2,2,2,2,2,2,2,2,2,2,2,2],
    [2,0,0,0,0,0,0,0,0,0,0,0,0,0,0,0,0,0,0,0,0,0,0,0,0,0,0,2],
    [2,0,1,1,1,1,0,0,0,1,1,1,1,0,0,1,1,1,1,0,0,0,1,1,1,1,0,2],
    [2,0,1,0,0,1,0,0,0,1,0,0,1,0,0,1,0,0,1,0,0,0,1,0,0,1,0,2],
    [2,0,1,1,1,1,0,0,0,1,1,1,1,0,0,1,1,1,1,0,0,0,1,1,1,1,0,2],
    [2,0,0,0,0,0,0,1,1,1,0,0,0,0,0,0,0,0,1,1,1,0,0,0,0,0,0,2],
    [2,0,0,0,0,0,0,1,0,0,0,2,2,2,2,2,2,0,0,0,1,0,0,0,0,0,0,2],
    [2,0,0,0,0,0,0,1,0,0,0,2,0,0,0,0,2,0,0,0,1,0,0,0,0,0,0,2],
    [2,0,1,1,1,1,0,1,0,0,0,2,0,0,0,0,2,0,0,0,1,0,1,1,1,1,0,2],
    [2,0,1,0,0,1,0,1,0,0,0,2,0,0,0,0,2,0,0,0,1,0,1,0,0,1,0,2],
    [2,0,1,1,1,1,0,1,0,0,0,2,0,0,0,0,2,0,0,0,1,0,1,1,1,1,0,2],
    [2,0,0,0,0,0,0,1,0,0,0,2,2,2,2,2,2,0,0,0,1,0,0,0,0,0,0,2],
    [2,0,0,0,0,0,0,1,1,1,0,0,0,0,0,0,0,0,1,1,1,0,0,0,0,0,0,2],
    [2,0,1,1,1,1,0,0,0,1,1,1,1,0,0,1,1,1,1,0,0,0,1,1,1,1,0,2],
    [2,0,1,0,0,1,0,0,0,1,0,0,1,0,0,1,0,0,1,0,0,0,1,0,0,1,0,2],
    [2,0,1,1,1,1,0,0,0,1,1,1,1,0,0,1,1,1,1,0,0,0,1,1,1,1,0,2],
    [2,0,0,0,0,0,0,0,0,0,0,0,0,0,0,0,0,0,0,0,0,0,0,0,0,0,0,2],
    [2,2,2,2,2,2,2,2,2,2,2,2,2,2,2,2,2,2,2,2,2,2,2,2,2,2,2,2]
  ],
  "spawn_1": [2, 2],
  "spawn_2": [25, 15]
}
